9 7

10 3 3 6 10 6 10 4 10 2 3 3 7
12 11 3 1 5 9 5 12 12 9 3 3 6
9 3 3 3 3 3 6 13 9 6 11 6 12 
10 2 3 3 3 6 8 3 3 5 10 5 12
13 12 14 10 6 12 12 11 3 2 5 10 5
10 5 12 12 9 5 8 3 1 5 11 4 14
9 6 12 12 14 14 13 10 3 2 3 5 12
10 1 5 9 1 1 3 5 11 5 10 3 4
12 14 10 3 2 6 10 6 10 2 4 11 5
9 1 5 14 13 9 5 9 5 12 9 3 7
