7 10

11	3	2	6	10	3	2	7	11	6	12	11	6
14	10	5	12	9	7	9	6	10	1	1	7	12
12	13	14	9	6	14	10	5	9	6	14	10	5
9	2	5	11	0	1	1	6	10	1	1	4	10
2	1	2	3	4	11	6	9	5	11	6	12	12
5	11	0	7	12	11	1	2	2	2	5	9	5
11	2	1	6	8	6	10	4	12	1	3	2	7
14	13	14	12	13	9	5	13	9	3	7	9	6	
1 	3	0	0	7	10	3	3	6	10	6	11	4
11	3	5	13	11	1	3	6	9	5	9	3	5
